......&.....
..&......&..
&.l...&....&
............
@###########
..o.........
&........&..
.&....&.....
...&....&..&